8,8
---.....
-1-.....
--#..#..
........
........
..#..#--
.....-2-
.....---