10,10
#........#
.......#..
..#.##..#.
..........
..#.##.#..
..#.##.#..
..........
.#..##.#..
..#.......
#........#