20,20
#..................#
.........##.........
....................
...#.#.#.##.#.#.#...
....................
...#.#.#.##.#.#.#...
....................
...#.#.#.##.#.#.#...
....................
.#.###.####.#.#.#.#.
.#.#.#.#.####.###.#.
....................
...#.#.#.##.#.#.#...
....................
...#.#.#.##.#.#.#...
....................
...#.#.#.##.#.#.#...
....................
.........##.........
#..................#