12,12
#..........#
............
............
............
............
............
............
..R......R..
............
....R..R....
............
#..........#